Cisco CallManager	CUCM	any
Cisco Unified Mobile Voice Access Service	CUCM	Publisher
Cisco IP Voice Media Streaming App	CUCM	any
Cisco CTI Manager	CUCM	any
Cisco Extension Mobility	CUCM	any
Cisco Extended Functions	CUCM	any
Cisco DHCP Monitor Service	CUCM	any
Cisco Dialed Number Analyzer Server	CUCM	any
Cisco Dial Number Analyzer	CUCM	any
Cisco Tftp	CUCM	any
Cisco IP Manager Assisistant	CUCM	any
Cisco WebDialer Web Service	CUCM	any
Cisco SOAP - CDRonDemand Service	CUCM	any
Cisco CAR Web Service	CUCM	any
Cisco AXL Web Service	CUCM	any
Cisco UXL Web Service	CUCM	any
Cisco Bulk Provisioning Service	CUCM	Publisher
Cisco TAPS Service	CUCM	Publisher
Cisco Serviceability Reporter	CUCM	any
Cisco CallManager SNMP Service	CUCM	any
Cisco CTL Provider	CUCM	any
Cisco Certificate Authority Proxy Function	CUCM	Publisher
Cisco DirSync	CUCM	Publisher
Cisco Intercluster Lookup Service	CUCM	any
Cisco Location Bandwidth Manager	CUCM	any
Cisco Directory Number Alias Sync	CUCM	any
Cisco Directory Number Alias Lookup	CUCM	any
Self Provisioning IVR	CUCM	any
Cisco AXL Web Service	IMP	any
Cisco Bulk Provisioning Service	IMP	any
Cisco Serviceability Reporter	IMP	any
Cisco SIP Proxy	IMP	any
Cisco Presence Engine	IMP	any
Cisco XCP Text Conference Manager	IMP	any
Cisco XCP Web Connection Manager	IMP	any
Cisco XCP Connection Manager	IMP	any
Cisco XCP SIP Federation Connection Manager	IMP	any
Cisco XCP XMPP Federation Connection Manager	IMP	any
Cisco XCP Message Archiver	IMP	any
Cisco XCP Directory Service	IMP	any
Cisco XCP Authentication Service	IMP	any